xxxxxxxxxxxxxxxxxx
xp1x     xvx s s2x
x  x vx  xsx   xsx
xx x  x sx x  vx x
xs    x sx x  vx x
xxxxxxx sx x     x
x        x xv    x
x x x            x
x x xxxxxxxxxxxxxx
x x xsxvxsxvxsxvxx
x                x
xxvxsxvxsxvxsxvxfx
xxxxxxxxxxxxxxxxxx